wbwbbbbbbw
wpw00000gw
w0b0bbbw0w
w000z00wzw
wbzw0w0w0w
wg0w0w0w0w
w0bb0wzb0w
w0000w000w
w0g0ww0gew
bbbbbbbbbb