wwwwwwwwww
wpw00000gw
w0w0wwww0w
w000z00w0w
wwzw0w0w0w
wg0w0w0w0w
w0ww0wzw0w
w0000w000w
w0g0ww0gzw
wwwwwwwwww