wwwwwwwwww
w p000000w
w0wwwwww0w
w0w0000w0w
w0w0gg0w0w
w0w0000w0w
w0wwwwww0w
w0000z000w
w0000000gw
wwwwwwwwww