wbbbbbbbbw
wp000000gw
w00000000w
w0wb00bw0w
w0wg00gw0w
w0bb00bb0w
w00000000w
w000z0000w
w0000000ew
bbbbbbbbbb