wbbbbwbbbw
w0g00b00ew
wb00b0w0bw
w00000w0zw
w0bbpbb00w
w0000000zw
w0bbbwbb0w
wg000b000w
ww0g0000zw
bbbbbbbbbb