wwwwwwwwew
wg00w0000w
w000www00w
www00000zw
w0000wwwww
wg0000000w
wwwww0000w
w00000000w
wp000wwg0w
wwwwwwwwww