wwwwwwwwww
wp00w000gw
ww00w0w0ww
w00000w00w
w0wwwww00w
w0z00000zw
w0wwwwww0w
wg000w000w
ww0g0000zw
wwwwwwwwww